######
#    #
# $+ #
#    #
######
;Sa
